#########
#  ###  #
#  # #  #
#  #A#  #
#       #
#a  B  b#
#########
