#########
#    abc#
## ######
## ######
##C######
#########
#########
