#########
#a      #
#b      #
#c      #
#d      #
#e  A  ##
#########
