#########
##  B   #
### a   #
##      #
### b   #
##  A   #
#########
