#########
#       #
# c#b#a #
#       #
#       #
#C     A#
#########
