#########
#A      #
#      c#
#      a#
#      b#
##      #
#########
