#########
#       #
# A   c #
#   #   #
# C   a #
#       #
#########
