#########
#   a  ##
#   b   #
#   c   #
#       #
#  A C  #
#########
