#########
#       #
#     C #
#  a#c  #
# A     #
#       #
#########
