#########
#    a###
# #  b###
# A#  ###
# #B# ###
##    ###
#########
