#########
#a#bcc###
# #   B##
# ##   ##
# ###  ##
#A ######
#########
