#########
#    #B #
#    ## #
#Ccab   #
#    ## #
#    #A #
#########
