#########
#   a  A#
#   c#  #
####c####
#  #c   #
#B  b   #
#########
