#########
####B####
#Cd b d##
#  c a A#
##d   d #
#########
#########
