#########
#########
#### ####
### c ###
## c c ##
#bA   Ba#
#########
