#########
#bc   C##
######e #
#A # #eB#
#da   e #
###D## ##
#########
