#########
#c e e d#
# C# #D #
# ##### #
# #B#A# #
#b     a#
#########
