#########
#eC e Ae#
#  #a#  #
# # c # #
##  b  ##
#  DdB  #
#########
