#########
# # #   #
#  B# C##
#b  #  c#
#a # D#d#
#A  # # #
#########
