#########
#    # C#
##      #
# baddc##
#       #
#B#  #A #
#########
