#########
# D # #C#
#   A   #
#  # da #
##   bc #
#B      #
#########
