#########
#d A#C  #
#  #b#  #
# # Bd# #
#  #d#  #
#d a#c  #
#########
