#########
#########
###B#####
#C  bacd#
####A#D##
#########
#########
