#########
#Deb    #
#Cea    #
#Aec    #
#Bed    #
##      #
#########
