#########
# #D  # #
#  #de  #
#B b#a A#
#  ec#  #
# # C # #
#########
