#########
# B  ####
#  c c###
## bca ##
###c c  #
####  A #
#########
