#########
# #a b#B#
#  d cA #
## e e ##
#       #
#D  #  C#
#########
