#########
#Aa # b##
# ddcdd #
##  #  B#
##     ##
##  C  ##
#########
