#########
#c##ac B#
#       #
#       #
#       #
# A  #bc#
#########
