#########
#   b   #
#   #c ##
#B     A#
## c#   #
#   a # #
#########
