#########
#d     ##
#   b # #
# B# #A #
# # c   #
##C    a#
#########
