#########
##  #c a#
#    #  #
#  B#   #
#  #A   #
#b c#   #
#########
