#########
#  b#a A#
#B# ##  #
#########
#  C# d #
# #c##D##
#########
