#########
####  ###
## cbc###
##B   A##
###cac ##
###  ####
#########
