#########
#     Cd#
#      d#
#   A  d#
#     c##
# B #ba##
#########
