#########
##B   A##
###    ##
#d#   #b#
#d     a#
#d  C  c#
#########
