#########
# A #ca##
#     c##
#      ##
#  #c  ##
# ##b B##
#########
