#########
### C ###
###  c###
### a A #
###b d###
# B   ###
#########
