#########
#B####dA#
#  bac  #
#   #   #
#       #
#   C   #
#########
