#########
##    #A#
## B    #
##a b c #
#  d d  #
#C###   #
#########
