#########
#  c#####
# b  ####
#Bc   cA#
####  a #
#####c  #
#########
