#########
# A   C #
# b e d #
##  e  ##
##a e c #
# B # D #
#########
