#########
#  B    #
#   #   #
##      #
#c      #
#ba    A#
#########
