#########
#b #   a#
#  #A   #
#  ### c#
#   B# c#
#    # c#
#########
