#########
# C   D #
# # # # #
#b a c d#
# # # # #
# B   A #
#########
