#########
#      A#
# #ddd  #
#  bac  #
#       #
#B     C#
#########
