#########
#########
### #####
#B ccaA #
## ccb  #
#########
#########
