#########
#b  B  a#
#  #    #
# D   A #
#    #  #
#d  C  c#
#########
