#########
##   bc #
# #B  cc#
#  #   a#
#   #   #
#    #A #
#########
