#########
# d    ##
#Cd   b##
#A    a #
#Bd   c##
# d    ##
#########
