#########
#   A   #
# #     #
#cab    #
#  #    #
#  B C  #
#########
