#########
# B a A #
#       #
#   c   #
#       #
##c b c##
#########
