#########
# #######
#B   ####
#      A#
#   ba  #
#c      #
#########
