#########
#A    #B#
# #a#C# #
# #c### #
# #d#D  #
# #b    #
#########
