#########
#B  #   #
# ###   #
#c b a c#
#   ### #
#   #  A#
#########
