#########
##   c###
# a  #  #
#  A#B  #
#  #  b #
#c#    ##
#########
