#########
#      B#
#D#b a  #
#     A #
#C#d c  #
#       #
#########
