#########
#B      #
#  #da  #
#  #bc C#
#  A    #
#       #
#########
