#########
#       #
# dbca# #
#       #
#       #
#B  A  C#
#########
