#########
## ccc#A#
#       #
# #   # #
#       #
#B#b a###
#########
