#########
#      A#
####a   #
# ccccc #
#   b####
#B      #
#########
