#########
#  A    #
#       #
#  #bac #
#  #d d #
#B #   C#
#########
