#########
##     A#
## #a#  #
#  ccc  #
#  #b#  #
#B      #
#########
