#########
##ddddd##
# b C c #
#       #
#       #
# B a A #
#########
