#########
####a####
# bd dc #
# ####  #
#  BA#  #
##   #C #
#########
