#########
#  bca  #
#  dCd  #
# ##### #
#  B#A  #
##  #   #
#########
