#########
#   #  A#
#   c # #
#  b a  #
# # c   #
#B      #
#########
