#########
#  bCa  #
#       #
#  d#d  #
#   d   #
#B  c  A#
#########
