#########
#dd     #
#ba  B A#
###     #
#  #    #
#Cc#    #
#########
