#########
#A #   ##
#a #c  ##
## #c# b#
##  c# B#
##   # ##
#########
