#########
##bbA  ##
##b######
##bbb####
####a# ##
#      ##
#########
