#########
# C #d a#
##   #d #
# # c #A#
#Bd#   ##
#b  #   #
#########
