#########
##     c#
#   B   #
#   b   #
#   a   #
#c  A   #
#########
