#########
#Bb # c #
# # # # #
# # # #C#
# #A# # #
# # a # #
#########
