#########
#bc    A#
# c     #
# c     #
# c     #
# ca  B #
#########
