#########
#   a   #
#B      #
#   c #A#
#  C    #
#   b   #
#########
