#########
#       #
# d #Bb #
#  ###  #
# aA#Cc #
#       #
#########
