#########
# #   C #
# A   # #
# #bac# #
# ##B## #
#       #
#########
