#########
#  dda A#
######  #
######  #
#   b   #
#B  #####
#########
