#########
# ###   #
#  d#   #
# aA#Cc #
#d  #   #
#   #   #
#########
