#########
#  bad  #
#      ##
#    # A#
# ####  #
#B   #  #
#########
