#########
#   #   #
#a  #  C#
#b     B#
#c     A#
#       #
#########
