#########
## abc ##
## ### ##
## A#C ##
## ### ##
##     ##
#########
