#########
# C     #
#    #A #
#  cab  #
#    #  #
#  B    #
#########
