#########
# abdd  #
# c     #
# ##### #
# ##BA# #
#     #C#
#########
