#########
#C cab  #
# ##### #
# #   A #
# #B### #
#       #
#########
