#########
#A    ###
# # c ###
### b # #
### a # #
###    C#
#########
