#########
#       #
#c #C#  #
#a A## d#
#b #B#  #
#       #
#########
