#########
#     #A#
#     # #
#  dad  #
#   b   #
#B      #
#########
