#########
###### B#
#  c c  #
#   #   #
#  a b  #
#A      #
#########
