#########
#  #a#  #
####A####
#bB###Cc#
# ##D## #
#e  d  e#
#########
