#########
#A ####c#
# # B # #
# # b # #
# #   # #
#a#d#e#C#
#########
