#########
#       #
#   a#A #
# ##b## #
# C#c   #
#       #
#########
