#########
#  #  B #
#       #
# a cb###
#     ###
#A    ###
#########
