#########
#########
#   B  ##
##b c a##
##  A   #
#########
#########
