#########
#    ddd#
# Aac   #
# CBb   #
#       #
#       #
#########
