#########
# A b c##
#       #
#B a c  #
#       #
#       #
#########
