#########
###    ##
### B   #
#       #
##      #
#  baA  #
#########
